6,6,6,6,6,6,6,6,6,6,6,6,6,6,6,6,6,6,6,6,6,6,6,6,6,6,6,6,
6,6,6,6,6,6,6,6,6,6,6,6,6,6,6,6,6,6,6,6,6,6,6,6,6,6,6,6,
6,6,6,6,6,6,6,6,6,6,6,6,6,6,6,6,6,6,6,6,6,6,6,6,6,6,6,6,
6,6,6,6,6,6,6,6,6,6,6,6,6,6,6,6,6,6,6,6,6,6,6,6,6,6,6,6,
1,1,1,1,1,1,1,1,1,1,1,1,1,1,1,1,1,1,1,1,1,1,1,1,1,1,1,1,
1,0,0,0,0,0,0,0,0,0,0,0,0,1,1,0,0,0,0,0,0,0,0,0,0,0,0,1,
1,0,1,1,1,1,0,1,1,1,1,1,0,1,1,0,1,1,1,1,1,0,1,1,1,1,0,1,
1,5,1,1,1,1,0,1,1,1,1,1,0,1,1,0,1,1,1,1,1,0,1,1,1,1,5,1,
1,0,1,1,1,1,0,1,1,1,1,1,0,1,1,0,1,1,1,1,1,0,1,1,1,1,0,1,
1,0,0,0,0,0,0,0,0,0,0,0,0,0,0,0,0,0,0,0,0,0,0,0,0,0,0,1,
1,0,1,1,1,1,0,1,0,1,1,1,1,1,1,1,1,1,1,0,1,0,1,1,1,1,0,1,
1,0,1,1,1,1,0,1,0,1,1,1,1,1,1,1,1,1,1,0,1,0,1,1,1,1,0,1,
1,0,0,0,0,0,0,1,0,0,0,0,0,1,1,0,0,0,0,0,1,0,0,0,0,0,0,1,
1,1,1,1,1,1,0,1,1,1,1,1,6,1,1,6,1,1,1,1,1,0,1,1,1,1,1,1,
6,6,6,6,6,1,0,1,1,1,1,1,6,1,1,6,1,1,1,1,1,0,1,6,6,6,6,6,
6,6,6,6,6,1,0,1,6,6,6,6,6,6,6,6,6,6,6,6,1,0,1,6,6,6,6,6,
6,6,6,6,6,1,0,1,6,1,1,1,1,2,2,1,1,1,1,6,1,0,1,6,6,6,6,6,
1,1,1,1,1,1,0,1,6,1,2,2,2,2,2,2,2,2,1,6,1,0,1,1,1,1,1,1,
4,6,6,6,6,6,0,6,6,1,2,2,2,2,2,2,2,2,1,6,6,0,6,6,6,6,6,4,
1,1,1,1,1,1,0,1,6,1,2,2,2,2,2,2,2,2,1,6,1,0,1,1,1,1,1,1,
6,6,6,6,6,1,0,1,6,1,1,1,1,1,1,1,1,1,1,6,1,0,1,6,6,6,6,6,
6,6,6,6,6,1,0,1,6,6,6,6,6,6,6,6,6,6,6,6,1,0,1,6,6,6,6,6,
6,6,6,6,6,1,0,1,6,1,1,1,1,1,1,1,1,1,1,6,1,0,1,6,6,6,6,6,
1,1,1,1,1,1,0,1,6,1,1,1,1,1,1,1,1,1,1,6,1,0,1,1,1,1,1,1,
1,0,0,0,0,0,0,0,0,0,0,0,0,1,1,0,0,0,0,0,0,0,0,0,0,0,0,1,
1,0,1,1,1,1,0,1,1,1,1,1,0,1,1,0,1,1,1,1,1,0,1,1,1,1,0,1,
1,0,1,1,1,1,0,1,1,1,1,1,0,1,1,0,1,1,1,1,1,0,1,1,1,1,0,1,
1,5,0,0,1,1,0,0,0,0,0,0,0,6,3,0,0,0,0,0,0,0,1,1,0,0,5,1,
1,1,1,0,1,1,0,1,0,1,1,1,1,1,1,1,1,1,1,0,1,0,1,1,0,1,1,1,
1,1,1,0,1,1,0,1,0,1,1,1,1,1,1,1,1,1,1,0,1,0,1,1,0,1,1,1,
1,0,0,0,0,0,0,1,0,0,0,0,0,1,1,0,0,0,0,0,1,0,0,0,0,0,0,1,
1,0,1,1,1,1,1,1,1,1,1,1,0,1,1,0,1,1,1,1,1,1,1,1,1,1,0,1,
1,0,1,1,1,1,1,1,1,1,1,1,0,1,1,0,1,1,1,1,1,1,1,1,1,1,0,1,
1,0,0,0,0,0,0,0,0,0,0,0,0,0,0,0,0,0,0,0,0,0,0,0,0,0,0,1,
1,1,1,1,1,1,1,1,1,1,1,1,1,1,1,1,1,1,1,1,1,1,1,1,1,1,1,1,
6,6,6,6,6,6,6,6,6,6,6,6,6,6,6,6,6,6,6,6,6,6,6,6,6,6,6,6,
6,6,6,6,6,6,6,6,6,6,6,6,6,6,6,6,6,6,6,6,6,6,6,6,6,6,6,6,
6,6,6,6,6,6,6,6,6,6,6,6,6,6,6,6,6,6,6,6,6,6,6,6,6,6,6,6