6,6,6,6,6,6,6,6,6,6,6,6,6,6,6,6,6,6,6,6,6,6,6,6,6,6,6,6,
6,6,6,6,6,6,6,6,6,6,6,6,6,6,6,6,6,6,6,6,6,6,6,6,6,6,6,6,
6,6,6,6,6,6,6,6,6,6,6,6,6,6,6,6,6,6,6,6,6,6,6,6,6,6,6,6,
6,6,6,6,6,6,6,6,6,6,6,6,6,6,6,6,6,6,6,6,6,6,6,6,6,6,6,6,
1,1,1,1,1,1,1,1,1,1,1,1,1,1,1,1,1,1,1,1,1,1,1,1,1,1,1,1,
1,8,0,0,0,0,8,0,0,0,0,0,8,1,1,8,0,0,0,0,0,8,0,0,0,0,8,1,
1,0,1,1,1,1,0,1,1,1,1,1,0,1,1,0,1,1,1,1,1,0,1,1,1,1,0,1,
1,5,1,1,1,1,0,1,1,1,1,1,0,1,1,0,1,1,1,1,1,0,1,1,1,1,5,1,
1,0,1,1,1,1,0,1,1,1,1,1,0,1,1,0,1,1,1,1,1,0,1,1,1,1,0,1,
1,8,0,0,0,0,8,0,8,0,0,0,8,0,0,8,0,0,0,8,0,8,0,0,0,0,8,1,
1,0,1,1,1,1,0,1,0,1,1,1,1,1,1,1,1,1,1,0,1,0,1,1,1,1,0,1,
1,0,1,1,1,1,0,1,0,1,1,1,1,1,1,1,1,1,1,0,1,0,1,1,1,1,0,1,
1,8,0,0,0,0,8,1,8,0,0,0,8,1,1,8,0,0,0,8,1,8,0,0,0,0,8,1,
1,1,1,1,1,1,0,1,1,1,1,1,6,1,1,6,1,1,1,1,1,0,1,1,1,1,1,1,
6,6,6,6,6,1,0,1,1,1,1,1,6,1,1,6,1,1,1,1,1,0,1,6,6,6,6,6,
6,6,6,6,6,1,0,1,7,6,6,6,7,6,6,7,6,6,6,7,1,0,1,6,6,6,6,6,
6,6,6,6,6,1,0,1,6,1,1,1,1,2,2,1,1,1,1,6,1,0,1,6,6,6,6,6,
1,1,1,1,1,1,0,1,6,1,2,2,2,2,2,2,2,2,1,6,1,0,1,1,1,1,1,1,
1,4,2,2,2,2,8,6,7,1,2,10,2,2,2,2,11,2,1,7,6,8,2,2,2,2,9,1,
1,1,1,1,1,1,0,1,6,1,2,2,2,2,2,2,2,2,1,6,1,0,1,1,1,1,1,1,
6,6,6,6,6,1,0,1,6,1,1,1,1,1,1,1,1,1,1,6,1,0,1,6,6,6,6,6,
6,6,6,6,6,1,0,1,7,6,6,6,6,6,6,6,6,6,6,7,1,0,1,6,6,6,6,6,
6,6,6,6,6,1,0,1,6,1,1,1,1,1,1,1,1,1,1,6,1,0,1,6,6,6,6,6,
1,1,1,1,1,1,0,1,6,1,1,1,1,1,1,1,1,1,1,6,1,0,1,1,1,1,1,1,
1,8,0,0,0,0,8,0,8,0,0,0,8,1,1,8,0,0,0,8,0,8,0,0,0,0,8,1,
1,0,1,1,1,1,0,1,1,1,1,1,0,1,1,0,1,1,1,1,1,0,1,1,1,1,0,1,
1,5,1,1,1,1,0,1,1,1,1,1,0,1,1,0,1,1,1,1,1,0,1,1,1,1,5,1,
1,8,0,0,1,1,8,0,8,0,0,0,8,6,3,8,0,0,0,8,0,8,1,1,0,0,8,1,
1,1,1,0,1,1,0,1,0,1,1,1,1,1,1,1,1,1,1,0,1,0,1,1,0,1,1,1,
1,1,1,0,1,1,0,1,0,1,1,1,1,1,1,1,1,1,1,0,1,0,1,1,0,1,1,1,
1,8,0,8,0,0,8,1,8,0,0,0,8,1,1,8,0,0,0,8,1,8,0,0,8,0,8,1,
1,0,1,1,1,1,1,1,1,1,1,1,0,1,1,0,1,1,1,1,1,1,1,1,1,1,0,1,
1,0,1,1,1,1,1,1,1,1,1,1,0,1,1,0,1,1,1,1,1,1,1,1,1,1,0,1,
1,8,0,0,0,0,0,0,0,0,0,0,8,0,0,8,0,0,0,0,0,0,0,0,0,0,8,1,
1,1,1,1,1,1,1,1,1,1,1,1,1,1,1,1,1,1,1,1,1,1,1,1,1,1,1,1,
6,6,6,6,6,6,6,6,6,6,6,6,6,6,6,6,6,6,6,6,6,6,6,6,6,6,6,6,
6,6,6,6,6,6,6,6,6,6,6,6,6,6,6,6,6,6,6,6,6,6,6,6,6,6,6,6,
6,6,6,6,6,6,6,6,6,6,6,6,6,6,6,6,6,6,6,6,6,6,6,6,6,6,6,6